长度	长度
出生日期	日期
专辑	编号
面积	面积
人口	人数
酒店地址	地址
房间数量	数量
身高	身高
逝世日期	日期
酒店星级	等级
营业时间	时间
人均价格	金额
创办时间	时间
体重	体重
游戏大小	软件大小
发行时间	时间
发布日期	日期
上映时间	时间
时间	时间
出版时间	时间
页数	页数
执行日期	日期
占地面积	面积
成立时间	时间
文号	编号
海拔	高度
片长	时长
定价	金额
地理位置	位置
ISBN	编号
建筑面积	面积
出品时间	时间
电话区号	号码
邮政区码	编号
开本	大小
大小	大小
集数	集数
型号	编号
耕地面积	面积
歌曲时长	时长
去世时间	时间
年代	年代
发行日期	日期
年平均气温	温度
地址	地址
绿化率	比例
下辖地区	地址
气候条件	气候条件
分子量	分子量
游戏站点	游戏站点
成立于	时间
分子式	分子式
首播时间	时间
始建于	时间
上市时间	时间
年龄	年龄
户数	户数
软件大小	软件大小
CAS号	编号
容积率	比例
国土面积	面积
每集长度	时长
imdb编码	编号
建成时间	时间
占地	占地
发布时间	时间
球衣号码	编号
开放时间	时间
规格	规格
屏幕尺寸	尺寸
游戏平台	游戏平台
耕地	耕地
调料	原料
建立时间	时间
游戏画面	游戏画面
创刊时间	时间
命名者及年代	命名者及年代
拍摄日期	日期
审定编号	编号
化学式	化学式
楼盘地址	地址
尺寸	尺寸
全长	长度
用法用量	用法用量
重量	重量
曲目数量	数量
配料	原料
日期	日期
CPU型号	编号
音乐时长	时长
门票价格	金额
国内刊号	编号
总投资	金额
发售日期	日期
物业费	金额
主料	原料
年降水量	年降水量
上线时间	时间
单位	单位
版本	版本
最新版本	编号
CPU主频	频率
编号	编号
国际刊号	编号
教职工	人数
学生人数	人数
所属专辑	专辑
竣工时间	时间
更新时间	时间
高	长度
软件版本	编号
在校学生	人数
开盘时间	时间
原料	原料
位于	位于
火车站距离	长度
长	长度
宽	长度
三围	长度
位置	位置
行政代码	编号
内存容量	容量
政府驻地	地址
邮发代号	编号
均价	金额
机场距离	长度
出生时间	时间
命名时间	时间
地点	地址
始建时间	时间
显卡芯片	编号
制片成本	金额
显存容量	容量
邮编	编号
总笔画	数量
分级	等级
平装	平装
学校地址	地址
操作系统	编号
主芯片组	编号
内径	尺寸
上市日期	日期
EINECS	编号
登场作品	作品名
主屏尺寸	尺寸
分辨率	分辨率
熔点	温度
票房	金额
工商注册号	编号
举办时间	时间
平均气温	温度
发现时间	时间
游戏版本	编号
施行时间	时间
教师人数	人数
项目位置	位置
生日	日期
第八条	条款
出生地	地址
注册资本	金额
毕业院校	院校
密度	密度
第七条	条款
第九条	条款
党员	人数
网络频率	频率
处理器	编号
字数	字数
尺寸/体积	尺寸
小区地址	地址
价格	金额
播出时间	时间
第六条	条款
需要等级	等级
创作年代	年代
员工数	人数
核准日期	日期
第十条	条款
第十二条	条款
第十一条	条款
降水量	降水量
提出时间	时间
第五条	条款
辖区面积	面积
人数	人数
入党时间	时间
耕地总面积	面积
通过时间	时间
第十四条	条款
建筑年代	年代
教学班	班级
营业期限开始日期	日期
第十三条	条款
第一条	条款
软件平台	编号
建造时间	时间
物品等级	等级
口径	尺寸
主要荣誉	荣誉
类型	类型
村民小组	人数
出生	日期
公交	编号
下辖	下辖
沸点	温度
第十五条	条款
条形码	条形码
学校代码	编号
建议游玩时长	时长
系统要求	配置
播放期间	时间
版次	编号
外形尺寸	尺寸
